11111111111111111111111111111
1n000000n00000000000n000000n1
10111111011111111111011111101
1n0000n1n00000000000n1n0000n1
10111101011111011111010111101
1n00n101n00000000000n101n00n1
10110101011111011111010101101
1n00n100n0n0000000n0n0n1n00n1
10110101010111211101010101101
1n00n0n10101g333g101010101101
101101010101g333g10101n0n00n1
10110101010111111101010101101
1n00n1n0n0n000n000n0n0n1n00n1
10110101011111011111010101101
1n00n101n00000n00000n101n00n1
10111101011111011111010111101
1n0000n1n00000n00000n1n0000n1
10111111011111111111011111101
1n000000n00000000000n000000n1
11111111111111111111111111111
